ә	misc
әбделдету	verb
әбделдеу	noun
әбден	adv
әбдесте	adv
әбдіре	noun
әбеқоңыр	noun
әбес	adj
әбессінбеу	verb
әбессіну	verb
әбестеу	adj
әбестік	noun
әбжылан	noun
әбжіл	adj
әбжілдік	noun
әбзел	noun
әбзелдеу	verb
әбзелді	adj
әбзелхана	noun
әбзелші	noun
әбсәтте	adv
Әбубәкір 	noun
әбүйір	noun
әбігер	noun
әбігерлендіру	verb
әбігерлену	verb
әбігерлеу	verb
әбігерлік	noun
әбігерсіз	adv
әбігершілік	noun
әбілет	noun
әбілхаят	noun
әбінауат	noun
әбіре	noun
әгәрәкім	misc
әдді	noun
әдеби	adj
әдеби-публицистикалық	adj
әдебиет	noun
әдебиеттану	noun
әдебиеттанушы	noun
әдебиеттік	adj
әдебиетші	noun
әдебиетшілік	adj
әдебилік	noun
әдегенде	adv
әдейлеп	adv
әдейі	adv
әдейілеп	adv
әдейілік	noun
әдемі	adj
әдемілендіру	verb
әдемілену	verb
әдемілеу	verb
әдемілік	noun
әдемірек adj	
әдемісу	verb
әдеміше	adj
әдеп	noun
әдепкі	adj
әдепкіде	adv
әдепкідей	adv
әдепсіз	adj
әдепсіздену	verb
әдепсіздеу	adj
әдепсіздік	noun
әдептеу	verb
әдепті	adj
әдептілік	noun
әдептілікпен	adv
әдет	noun
әдет-ғұрпы	noun
әдет-ғұрып	noun
әдет-ғұрыптылық	noun
әдетте	adv
әдеттегі	adj
әдеттегідей	adv
әдеттегілік	noun
әдеттенбегендік	noun
әдеттенген	adj
әдеттенгендік	noun
әдеттендіру	verb
әдеттену	verb
әдетті	adj
әдеттілік	noun
әдетшілдік	noun
әдетінше	adv
әділ	adj
әділдік	noun
әділет	noun
әділетсіз	adj
әділетсіздік	noun
әділетті	adj
әділеттік	noun
әділеттілік	noun
әділетшіл	noun
әділсіздік	noun
әдіп	noun
әдіптелген	adj
әдіптелу	verb
әдіптеме	noun
әдіптету	verb
әдіптеу	verb
әдіпті	adj
әдіс	noun
әдіс-айла	noun
әдіс-тәсіл	noun
әдіскер	adj
әдіскерлік	noun
әдісқой	adj
әдісқойлық	noun
әдіснама	noun
әдіснамалық	adj
әдіснаме	noun
әдіссіз	adj
әдістеме	noun
әдістемелік	adj
әдістену	verb
әдісші	noun
әдісшіл	adj
әдісшілдік	noun
әдісінше	adv
әже	noun
әжей	noun
әжеке	noun
әжелеу	verb
әжелік	noun
әжептәуір	adj
әжет	noun
әжетай	noun
әжетхана	noun
әжине	noun
әжуа	noun
әжуа-мазақ	noun
әжуа-сықақ	noun
әжуалау	verb
әжуашыл	noun
әжік	noun
әжім	noun
әжім-әжім	adj
әжімделу	verb
әжімдену	verb
әжімді	adj
әжімжапырақ	noun
әжімсіз	adj
әз	adj
әзаға	noun
әзәзіл	noun
әзәзілдей	
әзәзілдік	noun
әзәзілше	adv
әзборақ	noun
әздек	noun
әздік	noun
әзелде	adv
әзелден	noun
әзер	adv
әзіз	adj
әзіл	noun
әзіл-ажуа	noun
әзіл-күлкі	noun
әзіл-қалжың	noun
әзіл-ойын	noun
әзіл-оспақ	noun
әзіл-сықақ	noun
әзіл-шыны	noun
әзілдеп	adv
әзілдескіш	adj
әзілдесу	verb
әзілдеу	verb
әзілкеш	noun
әзілқой	noun
әзілқойлық	noun
әзілқұмар	noun
әзілмен	noun
әзілшіл	noun
әзір	adj
әзірбайжан	noun
әзірге	adv
әзіргі	adj
әзірде	adv
Әзірейіл	noun
әзірейіл	noun
әзірейілдей	adv
әзірет	adj
әзірленген	adj
әзірлену	verb
әзірлесу	verb
әзірлету	verb
әзірлеу	verb
әзірлеуші	noun
әзірлігі	noun
әзірлік	noun
әзірліксіз adv	
әзірше	adv
әзірінше	adv
әй	misc
әй-жәй	noun
әй-күй	noun
әй-түй	noun
әй-шәй	noun
әйәй	adj
әйбат	adj
әйгі	adj
әйгіленген	adj
әйгілену	verb
әйгілету	verb
әйгілеу	verb
әйгілеуші	noun
әйгілі	adj
әйгілік	noun
әйгілілемеу	noun
әйгілілік	noun
әйда	verb
әйдай	adj
әйдік	adj
әйдіңгер	noun
әйдіңгердей	adv
әйел	noun
әйел-еркек	noun
әйелдік	adj
әйелжанды	adj
әйелжандылық	noun
әйелқұмар	adj
әйелқұмарлық	noun
әйелсіну	verb
әйенкес	noun
әйеншек	noun
әйзік	noun
әйкел	noun
әйкелді	adj
әйкелтаяқ	noun
әйкен	adj
әйнек	noun
әйнекей	noun
әйнекейленген	adj
әйнекейлі	adj
әйнектей	adj
әйнектелген	adj
әйнектелу	verb
әйнектеу	verb
әйнектеуші	noun
әйнекті	adj
әйнекше	noun
әйнекші	noun
әйт	noun
әйт-шу	noun
әйтеуір	misc
әйткенмен	misc
әйтпегенде	adv
әйтпесе	adv
әйтсе	misc
әйтсе-дағы	misc
әйтіп-бүйтіп	misc
әк	noun
әке	noun
әке-көке noun	
әке-көкелеу	verb
әке-үке	noun
әке-шеше noun	
әкежан	noun
әкей	noun
әкей-үкей	noun
әкелгізу	verb
әкелдіру	verb
әкелетін	verb
әкелеу	verb
әкелту	verb
әкелу	verb
әкелі	adj
әкелі-балалы	adj
әкелік	adj
әкелім	noun
әкелінген	adj
әкеліну	verb
әкелісу	verb
әкемдікі	adj
әкеміздей	adv
әкендоз	noun
әкесіз	adv
әкесіздік	noun
әкесінше	adv
әкетай	noun
әкетай-көкетай	noun
әкеттіру	verb
әкету	verb
әкетуге	verb
әкетілу	verb
әкетілім	noun
әкетісу	verb
әкиек	noun
әккі	adj
әккілену	verb
әккілік	noun
әкқабық	noun
әкпіш	noun
әксөндіргіш	noun
әктас	noun
әктелу	verb
әктесу	verb
әктету	verb
әктеу	verb
әктеуші	noun
әкім	noun
әкімгерлік	noun
әкімгершілік	noun
әкімдік	noun
әкімият	noun
әкімқара	noun
әкімсу	verb
әкімсымақ	noun
әкімші	noun
әкімшіл	adj
әкімшіл-әміршіл	adj
әкімшілдік	noun
әкімшілік	noun
әкімшілік-аумақтық	adj
әкімшілік-басқару	noun
әкімшілік-территориялық	adj
әкімшілік-төрешілдік	noun
әкімшілік-шаруашылық	adj
әкімшілік-экономикалық	adj
әкірең	adj
әкіреңдесу	verb
әкіреңдеу	verb
әл	noun
әл-ауқат	noun
әл-ахуал	noun
әл-дәрмен	noun
әл-қадарынша	
әл-қуат	noun
әл-шама	noun
әлаулай	misc
әләуләй	misc
әлбеншөп noun	
әлбетте	adv
әлбұршақ noun
әлгі	adjpron
әлгіде	adv
әлгідегі	adj
әлгідегідей	adv
әлгідей	adv
әлгінде	adv
әлгіндегі	adj
әлгіндегідей	adj
әлгіндей	adj
әлгіше	adv
әлде	misc
әлдебір	adj
әлдебіреу	adj
әлдекім	adj
әлдекімсу	verb
әлдеқайда	adv
әлдеқайдағы	adv
әлдеқайдан	adv
әлдеқалай	adv
әлдеқандай	adj
әлдеқанша	adv
әлдеқашан	adv
әлдеқашанғы	adj
әлден	adv
әлдендіру	verb
әлдене	pron
әлденедей	adv
әлденендей	adj
әлденеше	adv
әлденешеу	adv
әлдену	verb
әлди	misc
әлди-әлди	misc
әлдилететін	adj
әлдилету	verb
әлдилеу	verb
әлді	adj
әлділік	noun
әлей	noun
әлейкүмассалам	misc
әлейкүмүссалам	misc
әлейім	noun
әлек	noun
әлек-шәлек	noun
әлеке	noun
әлекедей	adv
әлекей-шәлекей	noun
әлекей-шүлекей	noun
әлектендіру	verb
әлектену	verb
әлектету	verb
әлектеу	verb
әлекшөп	noun
әлем	noun
әлем-жәлем	adj
әлем-тапырақ	adv
әлем-тапырық	noun
әлемге	adv
әлемдеу	verb
әлемдік	adj
әлемет	adj
әлемиет	noun
әлемиеттік	adj
әлемтану verb	
әлеміш	adj
әлеміштену	verb
әлеміштеу	verb
әлемішті	adj
әлен-пәлен	misc
әлепет	noun
әлет	noun
әлеует	noun
әлеуетөлшеуіш	noun
әлеуетті	adj
әлеуеттік	adj
әлеуеттілік	noun
әлеумет	noun
әлеуметсіздену	verb
әлеуметтану	verb
әлеуметтанушы	noun
әлеуметтендіру	verb
әлеуметтену	noun
әлеуметті	adj
әлеуметтік	adj
әлеуметтік-мәдени	adj
әлеуметтік-саяси	adj
әлеуметтік-тұрмыстық	adj
әлеуметтік-экономикалық	adj
әлеуметшіл	adj
әлеуметшілік	noun
әлжуаз	adj
әлжуаздану	verb
әлжуаздық	noun
әлқисса	adv
әлме-әл	adv
әлменді	adj
әлмисақ	noun
әлөкпе	noun
әлпез	noun
әлпейім	adj
әлпеншек	noun
әлпет	noun
әлпетсіз	adj
әлпеттес	adj
әлпетті	adj
әлпеш	noun
әлпештену	verb
әлпештеу	verb
әлпешті	noun
әлпі	noun
әлпігүл	noun
әлпіншек	noun
әлсіз	adj
әлсізденген	adj
әлсіздендіру	verb
әлсіздену	verb
әлсіздеу	verb
әлсіздік	noun
әлсін	adv
әлсін-әлсін	adv
әлсін-әлі	adv
әлсіреген	adj
әлсіреді	verb
әлсірету	verb
әлсіреу	verb
әлтаман	adv
әлтек-тәлтек	adv
әлует	noun
әлуетсіз	adj
әлуетсіздік	noun
әлуетті	adj
әлуеттілік	noun
әлхам	misc
әлхамдилла	misc
әлхамдулла	misc
әлі	misc
әлік	noun
әлім	noun
әлім-берім	adj
әлімжеттік	noun
әлінше	adv
әліп	noun
әліпби	noun
әліпбилік	noun
әліпмай	noun
әліппе	noun
әліптеме	noun
әліптес	noun
әліптеу	noun
әм	misc
әман	adj
әманда	adv
әмбе	adjpron
әмбебап	noun
әмбебаптану	noun
әмбебаптық	adj
әмектес	noun
әмектестік	adj
әмеңгер	noun
әмеңгерлік	noun
әмеңгершілік	adj
әмин	misc
әмиян	noun
әмпей	adj
әмпей-жәмпей	adv
әмпейлесу	verb
әмпейлік	noun
Әмудария	noun
әмір	noun
әміре	noun
әміркен	adj
әмірләшкер	noun
әмірлі	adj
әмірлік	noun
әмірші	noun
әміршіл	adj
әміршіл-әкімшіл	adj
әміршілдік	noun
әміршілдік-төрешілдік	noun
әміршілік	noun
әмісе	adv
ән	noun
ән-әуен	noun
ән-би	noun
ән-жыр	noun
ән-күй	noun
әнбие	noun
әндеме	noun
әндету	verb
әндетіңкіреп	adv
әндетіп	adv
әндиқұл	noun
әндіген	noun
әндік	adj
әне	adv
әне-міне	adv
әнекей	adv
әнеки	adv
әнеугүнгі	adj
әнеугүні	adv
әнеугі	adj
әнжі	noun
әнжімді	adj
әнжіме	noun
әнқой	adj
әнқұмар	noun
әнсымақ	adj
әнтек	adv
әнұран	noun
әншейін	adv
әншейінде	adv
әнші	noun
әншібек	noun
әншіл	adj
әншілдік	noun
әншілік	adj
әні	adv
әніки	misc
әңгелек	noun
әңгүдік	adj
әңгүдіктену	verb
әңгүдіктік	noun
әңгі	adj
әңгілену	verb
әңгілік	noun
әңгіме	noun
әңгіме-дүкен	noun
әңгіме-сұхбат	noun
әңгімеқой	adj
әңгімеқумар	adj
әңгімеқұмар	adj
әңгімелесу	verb
әңгімелесуші	noun
әңгімелеу	verb
әңгімеші	noun
әңгімешіл	adj
әңгімешілдік	noun
әңгір	noun
әңгірлету	verb
әңгірлеу	verb
әңгіртаяқ	noun
әңкі-тәңкі	noun
әп	misc
әп-әдемі	adj
әп-әсем	adj
әп-сәтте	adv
әпбәрекелді	adj
әпеке	noun
әпенді	adj
әпенділеу	verb
әпенділік	adj
әпербақан	noun
әпербақандық	adj
әпергіш	adj
әперу	verb
әперісу	verb
әпке	noun
әпкіш	noun
әпсана	noun
әпсәтте	adv
әпсүн	noun
әпсітас	noun
әптер-тәптер	noun
әптиек	noun
әпті	adj
әр	adjpron
әралуан	noun
әрбір	adjpron
әрбіреу	adjpron
әрдайым	adv
әрдайымы	adv
әрегірек	adv
әредік	adv
әрекет	noun
әрекетсіз	adj
әрекетсіздік	noun
әрекеттегі	adj
әрекеттенбеу	verb
әрекеттену	verb
әрекеттенушілік	noun
әрекеттеп	adj
әрекеттес	noun
әрекеттескіш	noun
әрекеттестік	adj
әрекеттесу	noun
әрекеттесуші	noun
әрекетті	adj
әрекеттік	adj
әрекетшіл	adj
әректікен	noun
әрекідік	adv
әрем	adv
әрең	adv
әрең-әрең	adv
әржақты	adj
әржылдық	adj
әрине	adv
әркез	adv
әркелкі	adj
әркелкілену	verb
әркелкілік	adj
әркім	adjpron
әрқайда	adv
әрқайдан	adv
әрқайсы	adj
әрқайсысы	adjpron
әрқалай	adv
әрқашан	adv
әрқилы	adj
әрлендіру	verb
әрлену	verb
әрлеңкіреу	verb
әрлеу	verb
әрлеуші	noun
әрлі	adj
әрлі-берлі	adv
әрмен	adv
әрменде	adv
әрменірек	adv
әрне	pron
әрнеме	pron
әрнешік	adjpron
әрсіз	adj
әртарап	
әртараптандыру	verb
әртарапты	adj
әртекті	adj
әртектілік	noun
әртұрпаттық	adj
әртүрлі	adj
әртүрлілік	noun
әртілділік	noun
әртін	noun
әртінде	adv
әртіннен	adv
әртіс	noun
әртістік	adj
әруақ	noun
әруақты	adj
әрі	adv
әрі-бері adv	
әрі-беріден	
әрі-сәрі	adj
әрі-сәрілік	noun
әріде	adv
әріден	adv
әріп	noun
әріпдәрі 	noun
әріпсан	noun
әріптес	noun
әріптестік	noun
әріптік	adj
әріпшіл	adj
әріпшілдік	noun
әрірек	adv
әсел	noun
әсем	adj
әсемгүл	noun
әсемделген	adj
әсемделу	verb
әсемдену	verb
әсемдету	verb
әсемдеу	verb
әсемдік	noun
әсемділік	noun
әсемқалампыр	noun
әсемқой	noun
әсемпаз	noun
әсемпаздану	verb
әсемпаздық	noun
әсемсал	noun
әсемсарықас	noun
әсемсу	verb
әсемсіну	verb
әсемшымшық	noun
әсер	noun
әсерленгіш	adj
әсерленгіштік	noun
әсерленгіштілік	noun
әсерлендіру	verb
әсерлену	verb
әсерленушілік	noun
әсерлеңкіреу	verb
әсерлеу	verb
әсерлі	adj
әсерлілік 	adj
әсерсіз	adj
әсершіл	adj
әсершілдік	noun
әсет	noun
Әсет	noun
әсия	noun
әскер	noun
әскербасшылық	noun
әскербасы	noun
әскербасылық	noun
әскери	adj
әскери-әуе	noun
әскери-далалық	adj
әскери-дәрігерлік	adj
әскери-демократиялық	adj
әскери-инженерлік	adj
әскери-қолданбалы	adj
әскери-патриоттық	adj
әскери-саяси	adj
әскери-стратегиялық	adj
әскери-теңіз	adj
әскерилендірілу	adj
әскерлендіру	verb
әскерлік	adj
әския	noun
әспет	noun
әспеттеу	verb
әспетті	adj
әсте	adv
әсте-әсте	adv
әсіп	noun
әсіре	adv
әсіреаянпаздық	noun
әсіребейімділік	noun
әсіредемократ	noun
әсірежағымпаздық	noun
әсіреисламшыл	adj
әсіреқұрмет	noun
әсіреқызыл	adj
әсірелеу	verb
әсірелік	noun
әсіремәдениетті	adj
әсіремемлекетшіл	adj
әсіремемлекетшілдік	noun
әсіремұсылман	noun
әсірепатриот	noun
әсірепатриоттық	adj
әсіресақтық	adj
әсіресаясаттану	noun
әсіресе	adv
әсіресолшыл	adj
әсіресолшылдық	noun
әсіреұлтшыл	adj
әсіреұлтшылдық	noun
әтек	noun
әтекті	noun
әтектік	noun
әтеш	noun
әтешбалық	noun
әтештін	adj
әткеншек	noun
әткесші	noun
әткесшілік	noun
әттеген-ай	misc
әттегене	misc
әттегене-ай	misc
әттең	misc
әтір	noun
әтіргүл	noun
әтірлену verb	
әтірлеу	verb
әтірлі	adj
әтірмай	noun
әтірсу	verb
әу	misc
әудем	misc
әудемде	misc
әудемжер noun	
әудесу	verb
әуе	noun
әуе-ғарыштық	adj
әуе-десанттық	adj
әуегейлік	adj
әуедегі	adj
әуежай	noun
әуежол	noun
әуез	noun
әуездес	noun
әуездеу	verb
әуезді	adj
әуезділік noun	
әуезе	noun
әуезелену	verb
әуезелеу	verb
әуезовтану	noun
әуезовтанушы	noun
әуейі	adj
әуейілену	verb
әуейілік	noun
әуек	noun
әуекеме	noun
әуеқатынас	noun
әуел	noun
әуелгі	adj
әуелгіде	adv
әуелгідей	adv
әуелде	prep
әуелдегі	adj
әуелден	adv
әуелену	verb
әуелету	verb
әуелеу	verb
әуелі	adv
әуен	noun
әуендеме noun	
әуендес	adj
әуендестік	noun
әуендету	verb
әуендеу	verb
әуенді	adj
әуенділік	noun
әуенсіз	adj
әуес	adj
әуескер	noun
әуесқой	noun
әуесқойлар	adj
әуесқойлық	noun
әуестендіру	verb
әуестену	verb
әуестенуші	noun
әуестенушілік	noun
әуесті	adj
әуестік	noun
әуетаным	noun
әуетаяқ	noun
әуетозаңдандыру	verb
әуетозаңдатқыш	noun
әуке	noun
әукелектеу	verb
әукелену	verb
әукелі	adj
әукім-әукім	
әулекі	adj
әулекілендіру	verb
әулекілену	verb
әулекілік	noun
әулет	noun
әулетесім	noun
әулеттес	noun
әулетті	adj
әулеттік adj	
әулие	noun
әулие-әнбие	noun
әулиеағаш	noun
әулиелік	noun
әулиесіну	verb
әулиесіту	verb
әулігу	verb
әулікпе	noun
әумесер	adj
әумесерлену	verb
әумесерлік	noun
әумин	misc
әуп	misc
әупіл	noun
әупілдек	noun
әупілдеу	verb
әупірім	noun
әупірімдеу	verb
әупіріммен	adv
әуре	noun
әуре-сарсаң	noun
әуреленбеу	verb
әурелену	verb
әурелету	verb
әурелеу	verb
әурелік	noun
әурешілік	noun
әуселе	noun
әуіз	adj
әуір	noun
әуіт	noun
әфсана	noun
әш-пүш	misc
әшейін	adv
әшейінде	adv
әшекей	noun
әшекейленген	adj
әшекейлену	verb
әшекейлету	verb
әшекейлеу	verb
әшекейлеуші	noun
әшекейлі	adj
әшекейлік	adj
әшекеленген	adj
әшекелеу	verb
әшкере	adj
әшкерелейтін	adj
әшкерелену	verb
әшкерелету	verb
әшкерелеу	verb
әшкерелеуші	adj
әшкерелік	noun
ӘШҚ	noun
әшмөшке	noun
әшмүшке	noun
