ғабари	noun
ғадалат	noun
ғадалатты	adj
ғадауат	noun
ғадауатты	adj
ғадет	noun
ғаділ	noun
ғажаби	noun
ғажайып	adj
ғажайыптану	noun
ғажап	adj
ғажаптандыру	verb
ғажаптану	verb
ғажаптық	adj
ғазап	noun
ғазауат	noun
ғазел	noun
ғази	noun
ғазиз	adj
ғазиздік	noun
ғазы	noun
ғайбат	noun
ғайбатталған	adj
ғайбаттау	verb
ғайбатшы	noun
ғайналы	adj
ғайри	adjpron
ғайып	adj
ғайыпана	noun
ғайыппір	adj
ғайыптан	adv
ғайыптық	noun
ғайіш	noun
ғаклия	noun
ғақлия	noun
ғақлиялық	adj
ғақыл	noun
ғалам	noun
ғаламат	adj
ғаламдану	verb
ғаламдастық	noun
ғаламдастыру	verb
ғаламдастырылу	verb
ғаламдасу	verb
ғаламдық	adj
Ғаламтор	noun
ғаламшар	noun
ғаламшараралық	adj
ғаламшарлық	adj
ғаламшыл	adj
ғалила	noun
ғалым	noun
ғалымдық	noun
ғалымсу	verb
ғалымсымақ	noun
ғамкүн	adj
ғана	misc
ғани	noun
ғанибет	noun
ғанибетшілік	noun
ғанимет	noun
ғапу	noun
ғапулық	noun
ғапіл	noun
ғапілдік	noun
ғапілет	noun
ғарайып	
ғарап	
Ғарапа	
ғарасат	noun
ғарза	
ғаруз	
ғарыз	noun
ғарызнама	
ғарық	
ғарып-қасер	noun
ғарыш	noun
ғарышайлақ	
ғарышжай	noun
ғарышкеме	
ғарышкер	noun
ғарышкерлік	noun
ғарышкиім	noun
ғарышнама	
ғарыштану	
ғарыштау	verb
ғарыштық	adj
ғарышфизик	
ғарышфизика	
ғарышфизикалық	adj
ғарышхимик	
ғарышхимиялық	adj
ғаріп	adj
ғаріп-міскін	
ғаріпқана	
ғаріптік	
ғаріптілік	
ғаріпшілік	
ғасы	noun
ғасыр	noun
ғасырлардан	
ғасырлық	adj
ғасырнама	
ғасырнамалық	
ғауға	noun
ғафу	
ғафілдік	
ғашық	
ғашық-машық	
ғашықтай	
ғашықтық	noun
ғашырат	noun
ғаяр	
ғаярлану	verb
ғаярсыну	verb
ғибадат	noun
ғибадаттық	
ғибадатхана	noun
ғибрат	
ғибратнама	noun
ғибратсыз	
ғибратсыздық	noun
ғибраттану	verb
ғибраттанушы	noun
ғибратты	adj
ғидда	
ғизат	
ғизатты	adj
ғиззат	noun
ғиззатты	adj
ғилаж	noun
ғилман	adj
ғимарат	noun
ғинаят	
ғишрат	
ғиянаят	noun
ғоза	
ғой	misc
ғұзыр	
ғұлама	adj
ғұламалық	
ғұмыр	noun
ғұмырлы	adj
ғұмырлық	adj
ғұмырнама	noun
ғұмыры	adv
ғұмырынша	adv
ғұн	
ғұрбат	
ғұрлы	misc
ғұрлым	misc
ғұрпынша	
ғұрып	noun
ғұрыптану	noun
ғұрыптық	adj
ғұрыптылық	noun
ғұрыпшыл	adj
ғұсау	verb
ғұсыл	
ғұшыр	
ғылым	noun
ғылым-білім	noun
ғылымды	adj
ғылымдық	adj
ғылымдылық	noun
ғылыми	adj
ғылыми-әдістемелік	adj
ғылыми-зерттеу	adj
ғылыми-көпшілік	adj
ғылыми-қаржылық	adj
ғылыми-өндірстік	adj
ғылыми-өндірістік	adj
ғылыми-өнеркәсіптік	adj
ғылыми-практикалық	adj
ғылыми-сараптама	adj
ғылыми-тәлімдік	adj
ғылыми-теориялық	adj
ғылыми-техникалық	adj
ғылыми-фантастикалық	adj
ғылымилық	noun
ғылымпаз	noun
ғылымсымақ	noun
ғылымтану	noun
ғылымхал	adj
ғыш-ғыш	misc
