ібіліс	noun
ібілістік	noun
іждағат	noun
іждағатпен	
іждағатсыз	
іждағатсыздық	noun
іждағаттану	verb
іждағаттау	verb
іждағатты	adj
іждағаттылық	noun
із	noun
із-түз	
із-түзсіз	adv
ізашар	noun
ізбасар	noun
ізбасарлық	
ізбе-із	adv
ізбес	noun
ізбескелеу	
ізбестас	
ізбестену	verb
ізбестету	verb
ізбестеу	verb
ізбесті	adj
ізгі	adj
ізгіленген	adj
ізгілендіру	verb
ізгілік	noun
ізгіліксіз	
ізгілікті	adj
ізгіниетшілік	noun
іздеген	adj
іздегіш	noun
іздегіштік	noun
ізделу	verb
іздемпаз	adj
іздемпаздық	noun
ізденген	adj
ізденгіш	
ізденгіштік	noun
ізденді	adj
іздену	verb
ізденуші	noun
ізденушілік	noun
ізденімпаз	noun
ізденімпаздық	noun
ізденіс	noun
ізденіскер	noun
іздестіру	verb
іздесу	verb
іздеттіру	verb
іздету	verb
іздеу	verb
іздеулер	
іздеусіз	adj
іздеуші	adj
іздеушілік	noun
ізді	
іздік	
ізділік	
ізет	noun
ізетсіз	
ізетсіздік	noun
ізетті	adj
ізеттілік	noun
ізетшіл	
ізетшілік	noun