вавилон	noun
вавилондық	adj
вагон	noun
вагон-ресторан	noun
вагон-цистерна	noun
вагонетка	noun
вагонша	noun
вагоншашы	noun
вагонше	noun
вагоншы	noun
ваграншы	noun
ваза	noun
вазелин	noun
вакансия	noun
вакантты	adj
вакуоль	noun
вакуум	noun
вакуумдық	adj
вакх	noun
вакцина	noun
вакциналау	noun
вакцинация	noun
вал	noun
валансьен	noun
валентті	adj
валенттілік	noun
валеология	noun
валерьян	noun
валет	noun
валидол	noun
валик	noun
валокордин	noun
валоризация	noun
валторна	noun
валторнашы	noun
валуй	noun
вальс	noun
валюта	noun
валюталық	adj
валютасыз	adj
валюташы	noun
валюттендіру	verb
валютчик	noun
ванадий	noun
ванадийлі	adj
вандал	noun
вандалдық	adj
вандализм	noun
ванилинді	adj
ваниль	noun
ванильді	adj
ванна	noun
вапор	noun
варвар	noun
варваризм	noun
варварлық	adj
варенье	noun
вариант	noun
вариантты	adj
варианттылық	noun
вариация	noun
вариациялану	verb
вариациялау	verb
вариациялық	adj
варикоз	noun
варьете	noun
варяг	noun
вассал	noun
вассалдық	adj
ватер	noun
ватермашина	noun
ватерпас	noun
ватерпол	noun
ватерполо	noun
ватерпололық	adj
ватерполшы	noun
ватерсызық	noun
Ватикан	noun
ватин	noun
ватман	noun
ватрушка	noun
ватт	noun
ватт-метр	noun
ватт-сағат	noun
ватт-секунд	noun
ваттметр	noun
ваттық	adj
ваучер	noun
вафель	adj
вафельді	adj
вафельші	noun
вафли	noun
вафля	noun
вахабит	noun
вахмистр	noun
вахмитрлік	adj
вахта	noun
вахталық	adj
вахташы	noun
вахтер	noun
вахтерлік	adj
ваххабит	noun
ваххабизм	noun
веб-құрамдас	adj
веб-сайт	noun
веб-торап	noun
вегетариан	noun
вегетариандық	adj
вегетарианшыл	noun
вегетарианшылық	adj
вегетативтік	adj
вегетация	noun
вегетациялық	adj
веданта	noun
ведомость	noun
ведомство	noun
ведомствоаралық	adj
ведомстволық	adj
вексель	noun
вексельдік	adj
вектор	noun
векторлық	adj
великорус	noun
велодром	noun
веложарыс	noun
веложорық	noun
велокамера	noun
велокросс	noun
веломототрек	noun
велопокрышка	noun
велосапар	noun
велосипед	noun
велосипедистка	noun
велосипедші	noun
велоспорт	noun
велотрек	noun
велотұрақ	noun
велошабандоз	noun
вельбот	noun
вельвет	noun
велюр	noun
веляр	noun
веляризация	noun
венгр	noun
венерик	noun
венеролог	noun
венерология	noun
венесекция	noun
венесуэл	noun
венециялық	adj
вензель	noun
венок	noun
вентерьші	noun
вентилятор	noun
вентиляция	noun
веранда	noun
вербалдану	verb
вербалды	adj
вермахт	noun
вермишель	noun
вермут	noun
вернисаж	noun
веронал	noun
верп	noun
версификатор	noun
версификаторлық	adj
версификация	noun
верстак	noun
верстатка	noun
верстка	noun
версткалау	verb
верстомер	noun
вертикаль	noun
вертикальды	adj
верфь	noun
вершок	noun
весталка	noun
вестерн	noun
вестибулярлық	adj
вестибюль	noun
ветеринар	noun
ветеринария	noun
вето	noun
ветромер	noun
ветфельдшер	noun
ветчина	noun
вече	noun
веялка	noun
взвод	noun
взводтық	adj
вибратор	noun
вибрация	noun
вибрациялау	verb
вибрион	noun
вивисекция	noun
вигвам	noun
виза	noun
визалық	adj
византия	noun
византиялық	adj
визасыз	adj
визир	noun
визирлеу	verb
визит	noun
визитация	noun
визитка	noun
визуалды	adj
викинг	noun
виконт	noun
викторина	noun
вилла	noun
винегрет	noun
винт	noun
винтовка	noun
винттелу	verb
винттеп	adv
винттеу	verb
винтті	adj
винттік	adj
винчестер	noun
виньетка	noun
виола	noun
виолончель	noun
виолончельші	noun
вираж	noun
виртуалды	adj
виртуалдық	adj
виртуальдық	adj
виртуоз	noun
виртуоздық	adj
вирус	noun
вирусолог	noun
вирусология	noun
вирустасығыш	noun
вирусты	adj
вирши	noun
виски	noun
вискоз	noun
вискоза	noun
висмут	noun
вист	noun
витализм	noun
виталист	noun
витамин	noun
витаминді	adj
витаминдік	adj
витраж	noun
витрина	noun
вице-адмирал	noun
вице-министр	noun
вице-президент	noun
вицералдық	adj
вицмундир	noun
вишнуизм	noun
вобла	noun
водевиль	noun
водолазка	noun
воеводалық	adj
воеводство	noun
военком	noun
вожатый	noun
вокабула	noun
вокабулярий	noun
вокал	noun
вокалдандыру	verb
вокалды	adj
вокалдық	adj
вокализ	noun
вокализация	noun
вокализм	noun
вокалист	noun
вокзал	noun
волапюк	noun
волвянка	noun
волейбол	noun
волейболшы	noun
волномер	noun
волнорез	noun
волонтер	noun
волынка	noun
волынкашы	noun
вольт	noun
вольт-ампер	noun
вольтаж	noun
вольтаметр	noun
вольтершіл	noun
вольтершілдік	noun
вольтметр	noun
вольтоль	noun
вольтті	noun
вольттік	adj
вольфрам	noun
вольфрамит	noun
волюнтаризм	noun
волюнтарист	noun
волюнтаристік	adj
вона	noun
ворвань	noun
воронка	noun
вотум	noun
вотчиналық	adj
вояж	noun
втулка	noun
вуаль	noun
вулкан	noun
вулкандық	adj
вулканизация	noun
вулканизациялау	verb
вулканизм	noun
вулканология	noun
вульгаризм	noun
вьетнамдық	adj
